 XXXXX     
 X P X
 X X X
 X X X
 X   X
   X  
  XXX 
  *X  
 X*F X  	
 XXXXX    	