XXXXXX
XPXXXX
X*FX X
XXFX X
XFFFFX
XXXXXX